000000000000000000
001222222222222210
001211111111111210
000211111111111200
032222222222222240
000211111111111200
001211111111111210
001222222222222210
000000000000000000